R00000001 = aaaa
R00000002 = 0001
R00000003 = 0088
R00000004 = 0022
R00000005 = 0077
R00000006 = 0033
R00000007 = 0000
R00000008 = 0002
R00000009 = 0080
R0000000a = 0056
R0000000b = 0000
R0000000c = 9500
R0000000d = 9560
R0000000e = 0080
R0000000f = xxxx
Time:       1861
Cycles:      186
PC:         0036
